{
    "width": 12,
    "height": 8,
    "tiles": [
      "############",
      "#S    #    #",
      "#  T  #  T #",
      "#  ## # ## #",
      "#  ## # ## #",
      "#  T   #  G#",
      "#         #",
      "############"
    ]
  }
  