{
    "width": 10,
    "height": 8,
    "tiles": [
      "##########",
      "#S   T   #",
      "#  ## #  #",
      "#  T  #  #",
      "#  ## #  #",
      "#   T  G #",
      "#        #",
      "##########"
    ]
  }
  