
{
    "width": 10,
    "height": 8,
    "tiles": [
      "##########",
      "#S   ##  #",
      "#    ##  #",
      "#    ##  #",
      "#  ###   #",
      "#  #   G #",
      "#        #",
      "##########"
    ]
  }
  