{
    "width": 12,
    "height": 8,
    "tiles": [
      "############",
      "#S   #    G#",
      "#  # #  #  #",
      "#  # #  #  #",
      "#  ###  ## #",
      "#          #",
      "#    #     #",
      "############"
    ]
  }
  